111111111111111111111111111111
1P0100C0000010001C001C00000C01
100010000C001000100010C0001111
1C11110C011100C01000100000C001
100000000000000000001000000001
1000100C00000000101100000C0001
10000000000000000C010000111111
100001110010C0001111000C100001
10000010000000000C000111000001
100C0010000C0000000000C00000E1
1111101000000000110000000C1111
10000000000C00000000C000000001
10000C00011101000C000000000001
1000000000C0010000000C00000001
111111111111111111111111111111