1111111111111111111111111111111
1P0000000CC0000C0000C0000000001
1010010100100000101010010010101
1010010010101010000010000010101
10E000000C00C0000000000000000E1
1111111111111111111111111111111
10000000000000000000000000000E1
1111111111111111111111111111111